@headers
music = route101
!headers
@vars
. = GRASS_5
a = SAND_PATH_MID_M
P = GRASS_5^POKECENTER
!vars
@map
....................
....................
....................
....................
......PPPPP.........
......PPPPP.........
......PPPPP.........
......PPPPP.........
......PPPPP........a
........aaaaaaaaaaaa
...................a
....................
....................
....................
....................
....................
....................
....................
....................
....................
!map
@warps
20x11[1] = path->1x11[1]
20x10[1] = path->1x10[1]
20x9[1] = path->1x9[1]
!warps